1111111111111
1P00000000001
1000000000001
1C000000000E1
1111111111111
