11111111111111111111111111111
1P000000000000000000000000001
11111111111111111111111111101
11111111111111111111111111101
1E000000000C00000000000000001
11111111111111111111111111111
