1111111111111111111111111111111111
110001000100010C0100C1000100011111
1101010101010101010101010101011111
1101010101010101010101010101011111
1P010001000100010001000100010C00E1
1111111111111111111111111111111111
