1111111111111111
100000000000000111
1000000000000000001
1000000000000000001
1111111111111111111

