111111111
1P0000C01
1000000E1
111111111
