111111111111
1P0000000001
100000000111
1C00000001E1
111111111111
